#######################################
# Data types (KEYWORD1)
#######################################
Blinker	KEYWORD1
BlinkerButton	KEYWORD1
BlinkerRGB	KEYWORD1
BlinkerSlider	KEYWORD1
BlinkerNumber	KEYWORD1
BlinkerTEXT	KEYWORD1
BlinkerJoystick	KEYWORD1
BUILTIN_SWITCH	KEYWORD1
BLINKER_DEBUG	KEYWORD1
BlinkerTimer	KEYWORD1

BlinkerAliGenie	KEYWORD1
BlinkerDuerOS	KEYWORD1
BlinkerUpdater	KEYWORD1

#######################################
# Methods and Functions (KEYWORD2)
#######################################
begin	KEYWORD2
connect	KEYWORD2
disconnect	KEYWORD2
connected	KEYWORD2
connected	KEYWORD2
available	KEYWORD2
readString	KEYWORD2
print	KEYWORD2
delay	KEYWORD2
notify	KEYWORD2
attachHeartbeat	KEYWORD2
attachParse	KEYWORD2
attachClick	KEYWORD2
attachDoubleClick	KEYWORD2
attachLongPressStart	KEYWORD2
attachLongPressStop	KEYWORD2
attachDuringLongPress	KEYWORD2
attachLongPressPowerdown	KEYWORD2
attachLongPressReset	KEYWORD2
pressedTime	KEYWORD2
attach	KEYWORD2
icon	KEYWORD2
color	KEYWORD2
text	KEYWORD2
brightness	KEYWORD2
unit	KEYWORD2
ahrs	KEYWORD2
attachAhrs	KEYWORD2
detachAhrs	KEYWORD2
gps	KEYWORD2
vibrate	KEYWORD2
timingState	KEYWORD2
loopState	KEYWORD2
countdownState	KEYWORD2
deleteTiming	KEYWORD2
deleteLoop	KEYWORD2
deleteCountdown	KEYWORD2
deleteTimer	KEYWORD2
setTimezone	KEYWORD2
time	KEYWORD2
second	KEYWORD2
minute	KEYWORD2
hour	KEYWORD2
wday	KEYWORD2
mday	KEYWORD2
yday	KEYWORD2
month	KEYWORD2
year	KEYWORD2
bridge	KEYWORD2
bridgeAvailable	KEYWORD2
bridgeRead	KEYWORD2
bridgePrint	KEYWORD2
bridgeBeginFormat	KEYWORD2
bridgeEndFormat	KEYWORD2
configUpdate	KEYWORD2
configGet	KEYWORD2
configDelete	KEYWORD2
dataStorage	KEYWORD2
dataUpdate	KEYWORD2
dataGet	KEYWORD2
dataDelete	KEYWORD2
sms	KEYWORD2
push	KEYWORD2
wechat	KEYWORD2
weather	KEYWORD2
aqi	KEYWORD2
status	KEYWORD2
flush	KEYWORD2
init	KEYWORD2
beginAuto	KEYWORD2
autoInput	KEYWORD2
autoInput	KEYWORD2
autoRun	KEYWORD2
setType	KEYWORD2
type	KEYWORD2
reset	KEYWORD2
tick	KEYWORD2
BLINKER_LOG	KEYWORD2
BLINKER_LOG	KEYWORD2
BLINKER_LOG	KEYWORD2
BLINKER_LOG	KEYWORD2
BLINKER_LOG	KEYWORD2
BLINKER_LOG	KEYWORD2
BLINKER_LOG	KEYWORD2
BLINKER_ERR_LOG	KEYWORD2
BLINKER_LOG_FreeHeap	KEYWORD2
BLINKER_PRINT	KEYWORD2
BLINKER_DEBUG_ALL	KEYWORD2
BLINKER_ESP_SMARTCONFIG	KEYWORD2
BLINKER_APCONFIG	KEYWORD2
BLINKER_BLE	KEYWORD2
BLINKER_WIFI	KEYWORD2
BLINKER_MQTT	KEYWORD2
BLINKER_PRO	KEYWORD2
BLINKER_AT_MQTT	KEYWORD2
BLINKER_AT_PRO	KEYWORD2
BLINKER_NBIOT	KEYWORD2
BLINKER_ESP_AT	KEYWORD2
BLINKER_BUTTON_LONGPRESS_POWERDOWN	KEYWORD2

BLINKER_MAX_SEND_SIZE	KEYWORD2
BLINKER_MAX_READ_SIZE	KEYWORD2

BLINKER_ALIGENIE_LIGHT	KEYWORD2
BLINKER_ALIGENIE_OUTLET	KEYWORD2
BLINKER_ALIGENIE_SWITCH	KEYWORD2
BLINKER_ALIGENIE_SENSOR	KEYWORD2

BLINKER_DUEROS_LIGHT	KEYWORD2
BLINKER_DUEROS_OUTLET	KEYWORD2
BLINKER_DUEROS_SWITCH	KEYWORD2
BLINKER_DUEROS_SENSOR	KEYWORD2

BLINKER_CMD_READING	KEYWORD2
BLINKER_CMD_MOVIE	KEYWORD2
BLINKER_CMD_SLEEP	KEYWORD2
BLINKER_CMD_HOLIDAY	KEYWORD2
BLINKER_CMD_MUSIC	KEYWORD2
BLINKER_CMD_COMMON	KEYWORD2

BLINKER_CMD_QUERY_ALL_NUMBER	KEYWORD2
BLINKER_CMD_QUERY_POWERSTATE_NUMBER	KEYWORD2
BLINKER_CMD_QUERY_COLOR_NUMBER	KEYWORD2
BLINKER_CMD_QUERY_MODE_NUMBER	KEYWORD2
BLINKER_CMD_QUERY_COLORTEMP_NUMBER	KEYWORD2
BLINKER_CMD_QUERY_BRIGHTNESS_NUMBER	KEYWORD2
BLINKER_CMD_QUERY_TEMP_NUMBER	KEYWORD2
BLINKER_CMD_QUERY_HUMI_NUMBER	KEYWORD2
BLINKER_CMD_QUERY_PM25_NUMBER	KEYWORD2

attachPowerState	KEYWORD2
attachColor	KEYWORD2
attachMode	KEYWORD2
attachCancelMode	KEYWORD2
attachBrightness	KEYWORD2
attachRelativeBrightness	KEYWORD2
attachColorTemperature	KEYWORD2
attachRelativeColorTemperature	KEYWORD2
attachQuery	KEYWORD2
attachSummary	KEYWORD2
attachData	KEYWORD2
STRING_format	KEYWORD2
powerState	KEYWORD2
colorTemp	KEYWORD2
temp	KEYWORD2
humi	KEYWORD2
pm25	KEYWORD2
pm10	KEYWORD2
ppm	KEYWORD2
co2	KEYWORD2
mode	KEYWORD2

stream	KEYWORD2
debugAll	KEYWORD2
BLINKER_OTA_VERSION_CODE	KEYWORD2

#######################################
# Literals (LITERAL1)
#######################################
Yaw	LITERAL1
Roll	LITERAL1
Pitch	LITERAL1
LONG	LITERAL1
LAT	LITERAL1
